{
  "phonemes": {
    "、": 0,
    "。": 1,
    "ぁ": 2,
    "あ": 3,
    "ぃ": 4,
    "い": 5,
    "ぅ": 6,
    "う": 7,
    "ぇ": 8,
    "え": 9,
    "ぉ": 10,
    "お": 11,
    "か": 12,
    "が": 13,
    "き": 14,
    "ぎ": 15,
    "く": 16,
    "ぐ": 17,
    "け": 18,
    "げ": 19,
    "こ": 20,
    "ご": 21,
    "さ": 22,
    "ざ": 23,
    "し": 24,
    "じ": 25,
    "す": 26,
    "ず": 27,
    "せ": 28,
    "ぜ": 29,
    "そ": 30,
    "ぞ": 31,
    "た": 32,
    "だ": 33,
    "ち": 34,
    "ぢ": 35,
    "っ": 36,
    "つ": 37,
    "づ": 38,
    "て": 39,
    "で": 40,
    "と": 41,
    "ど": 42,
    "な": 43,
    "に": 44,
    "ぬ": 45,
    "ね": 46,
    "の": 47,
    "は": 48,
    "ば": 49,
    "ぱ": 50,
    "ひ": 51,
    "び": 52,
    "ぴ": 53,
    "ふ": 54,
    "ぶ": 55,
    "ぷ": 56,
    "へ": 57,
    "べ": 58,
    "ぺ": 59,
    "ほ": 60,
    "ぼ": 61,
    "ぽ": 62,
    "ま": 63,
    "み": 64,
    "む": 65,
    "め": 66,
    "も": 67,
    "ゃ": 68,
    "や": 69,
    "ゅ": 70,
    "ゆ": 71,
    "ょ": 72,
    "よ": 73,
    "ら": 74,
    "り": 75,
    "る": 76,
    "れ": 77,
    "ろ": 78,
    "わ": 79,
    "を": 80,
    "ん": 81,
    "ゔ": 82,
    "ゖ": 83,
    "・": 84,
    "ー": 85
  }
}